====================
S................===
================.===
========.====....===
==.......====.==.===
=..==.=.=====.==...=
=.===.=======.======
=.===............===
=.===.==.=====.=====
=====.==.===...=====
=====.==.===.=======
=====.==.......=====
==....==.=====.=====
==.==.==.=====.=====
==.==.==.=====.=====
=====.==.=====.=====
=====.==.=====......
=====.==.===========
=====.==....========
=====E==============
