==========================================================
==...=====.====.==========================================
==.=.=====.====.=============...===...====================
==.=.=====.====.=============.=.===.=.====================
==.=.==.==.====.==.==========.=.===.=.====================
==.=.==.==========.==========.=.===.=.====================
==.=.==............==========.=.===.=.===..............===
==.=.========================.=.===.=.===.============.===
==.=........===...........===.=.===.=.===.============.===
==.========.===.=========.===.=.===.=.===.============.===
==.========.===.=========.===.=.===.=.===.============.===
==.========.===.=.........===.=.===.=.===.============.===
==.========.===.=.===========.=.===.=.===.============.===
==.========.===.=.===========.=.===.=.===.============.===
==.========.===.=.===========.=.===.=.===.============.===
==.========.....=.............=.....=.....=............===
==.========================================.==============
==S========================================E==============
