===========
..........=
.=.=.===.==
.=.===...==
S=E========
