===============S====
=......===.......===
=.====.====.========
=.====.=.==......===
==.......====.==.===
=..==.=.=====.==...=
=.===.=======.======
=.===............===
=.===.==.=====.=====
=====.==.===...=====
=====.==.===.=======
=====.==.......=====
==....==.=====.=====
==.==.==.=====.=====
==.==.==.=====.=====
=====.==.=====.=====
=====.==.=====.....=
=====.==.===========
=====.==....==.....=
==================E=
