===================E==========
===================........===
==========================.===
=======....................===
=======.==================.===
=======.==================.===
=======.====......========.===
======.......====.========.===
======.==========.========.===
======.==========.========.===
===....==========......===.===
===.==.===============.===.===
===.==.==.....========.=...===
===.==.==.===.========.=.=====
===.==....===.========...=====
===.=========.....============
======.....==.===.============
======.===.==.===.============
===....===....===.......======
======S=======================
