==================S=
==..===.........==.=
===.===.===.===.==.=
===.===.===........=
===.....=======.====
=======.===.===.====
===.....===.===.====
===.=======.......==
===.=========.===.==
===....======.===.==
======.======.....==
======......========
======.====.========
==.....====.......==
==.=======..=====.==
==.........====...==
====.=====......====
=.....====.====.====
=.===......====.====
=E==================
