====================
=......===.........S
=.====.====.========
=.====.=.==......===
==.......====.==.===
=..==.=.=====.==...=
=.===.=======.======
=.===............===
=.===.==.=====.=====
=.....==.===...=====
=====.==.===.=======
=====.==.......=====
==....==.=====.=====
==.==.==.=====.=====
==.==.==.......=====
==.==...======.=====
==.==.==.=====.....=
==.==.==.===========
==.................=
==================E=
