====================
S.........==========
===.=====........===
===.=====.======.===
===.=====........===
===.......======.===
=========.======.===
===................=
===.======.=======.=
===.======.=======.=
===.======......==.=
===........====.==.=
========.======.==.=
==....==.======....=
E..==.==.======.====
==.==.==........====
==.==....===========
==....==============
====================
