============
=..........=
=.=.=.===.==
=.=.===...==
=S=E========
