===================E==========
===...........=====........===
===.=========.============.===
===.===...........=........===
===.....=========.========.===
=======.=========......===.===
=======.====......====.===.===
======.......====..........===
======.==========.========.===
======.======.....========.===
===....======.===......===.===
===.==.===============.===.===
===.==.==.....========.=...===
===.==.==.===.========.=.=====
===.==....===.========...=====
===.=========.....============
===........==.===.=====....===
======.===.==.===.=====.======
===....===....===.......======
======S=======================
