=S==================
=.====.===.....=====
=.====.===.=========
=......===.....=====
=.====.===.=========
=.====...........===
=.==============.===
=.========.......===
=.========.=========
=.========.=========
=.========.=========
=.......==.......===
======.=========.===
======.=======...===
==......======.=====
==.====.======.=====
==.====.======.=====
==.====.======.=====
==......============
=======...====.=====
=========E==========
