=======E=======================S=
=.==....=====....======....====.=
=.==.===========.======.==.====.=
=....=.......===...........====.=
=.====.=====.===.==.===.=======.=
=......=====........===.........=
=================================
